-------------
-11111111111-
-1x000000001-
-10333333001-
-10111011101-
-10100000005-
-10107111111-
-40003S30001-
-11100111101-
-60000000001-
-10111111104-
-100000000f1-
-11111111111-
-------------
