level1
-------------
-11111111111-
-1x000000001-
-10333333001-
-10111011101-
-10000000005-
-10116111101-
-40003330001-
-10100111101-
-60000000001-
-10111111104-
-100000000f1-
-11111111111-
-------------


level2
---------------------
-1111111111111111111-
-1111150000000000001-
-1114000111101110004-
-1114000111101111104-
-1114003330001100004-
-1111111111101101111-
-10000000001011000f1-
-1011111110101111111-
-1011111110100333006-
-4000333000111111101-
-400011111x111111101-
-40001111101111111011-
-1110111110000000001-
-1110111111111000111-
-1110111000333000111-
-1110111011111111111-
-1110000000111111111-
-1111111000111111111-
-11111110000333000f1-
-1111111111111111111-
---------------------

level3
---------------------
-2222222222222222222-
-2x00002000000000004-
-2222202000222222202-
-2222202000000000502-
-2033302222222000202-
-2022222200000220202-
-2022000002200220202-
-2022022222202000204-
-4020022f02202022204-
-4020222200002020004-
-4020000000222020222-
-2022222000222020222-
-2033302022222020002-
-2222202022222000202-
-2222202000002220202-
-4000002222202220202-
-4000222222200000202-
-4000222222222000202-
-2000000333000000005-
-2222222222222222222-
---------------------

level4
---------------------
-222222222f222222222-
-2222222000002222222-
-2222222020200002222-
-2224000050500004222-
-2224000020222204222-
-2224022220222204222-
-2000022220222200002-
-2000000000000000002-
-4062222220222222704-
-400333000x000333004-
-4022222220000222204-
-2002222220222222002-
-2202222220222222022-
-2202222220222000022-
-2200003330333000022-
-2240002220222000422-
-2240002220222220422-
-2240002220222000422-
-2222500033300052222-
-2222244422244422222-
---------------------

level5
---------------------
-1111111111111111111-
-1x00000033300000005-
-1000010111111110001-
-1000000000000333001-
-1111333100011110104-
-1000000000000010104-
-1011101171111010104-
-5000000000011010101-
-1000111111011010006-
-4000333000011010111-
-4011111101011010101-
-4033300101011010101-
-1011110101011010101-
-6000010101011010101-
-1111010101000010004-
-1001010101000010104-
-1011010100033310104-
-1000010101111010101-
-1f00000101000000511-
-1111711111111111111-
---------------------
