-------------
-11111111111-
-1x000000001-
-10444444401-
-10111111101-
-10000000001-
-10111111101-
-10000000001-
-10111111101-
-10000000001-
-10111111101-
-100000000f1-
-11111111111-
-------------