-------------
-11111111111-
-1x000000001-
-10333333001-
-10111011101-
-10000000005-
-10116111101-
-40003930001-
-10100111101-
-70000000001-
-10111111104-
-100000000f1-
-11111111111-
-------------
