-------------
-11111111111-
-1x000000001-
-10333s33001-
-10111011101-
-10100s00005-
-10107111111-
-40003330001-
-11100111101-
-60000000001-
-10111111104-
-100000000f1-
-11111111111-
-------------
