-------------
-11111111111-
-1x000s00001-
-10333333001-
-10111011111-
-10100s00005-
-11107111101-
-40003330001-
-10111111111-
-60000100001-
-11110111104-
-1s0000000f1-
-11111111111-
-------------
