---------------------
-1111111111111111111-
-1111150000000000001-
-1114000011111110004-
-111400s011111111104-
-1114003330001100004-
-1111111111101101111-
-10000000001011000f1-
-1011111110101111111-
-1011111110100333006-
-4000333000111111101-
-400011111x111111101-
-40001111101111111011-
-1110111110000000001-
-1110111111111s00511-
-1110111000333000111-
-1110111011111111111-
-1110000000111111111-
-1111171000111111111-
-11111110000333000f1-
-1111111111111111111-
---------------------
