---------------------
-1111111111111111111-
-1111150000000000001-
-1111000011111110004-
-1111000011111111104-
-1111s03330001100004-
-1111111111101101111-
-10000000001011000f1-
-1011111110101111111-
-1011111110100333006-
-4s00333000111111101-
-400011111x111111101-
-40001111101111111011-
-1110111110000000001-
-1110111111111000501-
-1110111000333000101-
-1110111011111111101-
-11100000001111111s1-
-1111171000111111101-
-11111110000333000f1-
-1111111111111111111-
---------------------
