---------------------
-2222222222222222222-
-2x00002000000000004-
-2222202000222222202-
-2222202000000000502-
-2033302222222000202-
-2022222200000220202-
-2022000002200220202-
-2022022222202000204-
-4020022f02202022204-
-4020222200002020004-
-4020000000222020222-
-2022222000222020222-
-2033302022222020002-
-2222202022222000202-
-2222202000002220202-
-4000002222202220202-
-4000222222200000202-
-4000222222222000202-
-2000000333000000005-
-2222222222222222222-
---------------------