---------------------
-2222222222222222222-
-2x00002000000000004-
-22222020s0222222202-
-22222020000s0000502-
-2033302222222000202-
-2022222200000220202-
-2022000002200220202-
-2022022272202000204-
-4020022f02202022204-
-4020222200002020004-
-402000s000622020222-
-2022222000222020222-
-2033302022222020002-
-2222202022222000202-
-2222202000002220202-
-4000002222202220202-
-40s022222260s000202-
-40002222222220s0202-
-2000000333000000005-
-2222222222222222222-
---------------------
