---------------------
-2222222222222222222-
-2x00002000000000002-
-22222020s0222222202-
-2222202000000000502-
-2033300022222000202-
-2022222200000220202-
-2022000002200220202-
-2022022272205000204-
-4020022f00002022204-
-4020222200002020002-
-402000s000622020222-
-2022222000222020222-
-2033302022222020002-
-2222202022222000002-
-2222202000002222202-
-2000002222002220202-
-20002222226s0000202-
-6000222222202s00205-
-2000000333002000002-
-2222222222222222222-
---------------------
