---------------------
-222222290f002222222-
-2222222000002222222-
-2222222020200002222-
-2224000020200002222-
-2222000020222204222-
-2224022220222204222-
-2000022222222200s06-
-20s0000000000000002-
-4062222220222222704-
-200333000x000333002-
-4022222220000222204-
-2002222220222222002-
-2502222220222222052-
-2202222220222000022-
-2200008320233000022-
-2200002220222000022-
-2260002220222220622-
-2200002220222000s22-
-2222000030300009222-
-2222244422244422222-
---------------------
