---------------------
-222222292f222222222-
-2222222000002222222-
-2222222020200002222-
-2224000020200004222-
-2224000020222204222-
-2224022220222204222-
-2000022222222200s06-
-20s0000000000000002-
-4062222220222222704-
-400333000x000333004-
-4022222220000222204-
-2002222220222222002-
-2202222220222222022-
-2502222220222000052-
-22000083202330s0022-
-2240s02220222000422-
-2260002220222220622-
-2240002220222000422-
-2222000030300009222-
-2222244422244422222-
---------------------
