---------------------
-222222222f222222222-
-2222222000002222222-
-2222222020200002222-
-2224000050500004222-
-2224000020222204222-
-2224022220222204222-
-2000022220222200002-
-2000000000000000002-
-4062222220222222704-
-400333000x000333004-
-4022222220000222204-
-2002222220222222002-
-2202222220222222022-
-2202222220222000022-
-2200003330333000022-
-2240002220222000422-
-2240002220222220422-
-2240002220222000422-
-2222500033300052222-
-2222244422244422222-
---------------------