---------------------
-1111111111111111111-
-1x00000033300000005-
-1000010111111110001-
-1000000000000333001-
-1111333100011110104-
-1000000000000010104-
-1011101171111010104-
-5000000000011010101-
-1000111111011010006-
-4000333000011010111-
-4011111101011010101-
-4033300101011010101-
-1011110101011010101-
-6000010101011010101-
-1111010101000010004-
-1001010101000010104-
-1011010100033310104-
-1000010101111010101-
-1f00000101000000511-
-1111711111111111111-
---------------------