---------------------
-1111111111111111111-
-1x00000133300000001-
-10s0010111111110s08-
-1000010000000333101-
-1111313100011110104-
-1000000000000010104-
-1019001171111010104-
-1000000000011010101-
-60s0111111011010006-
-1000333000011010111-
-4011111101011010001-
-1033300101051010101-
-1011110101011010101-
-5000010101011010101-
-1111010501000010001-
-1001010101000011104-
-1091010100033300104-
-100s010101111010101-
-1f00010000000000001-
-1117111111111111111-
---------------------
