---------------------
-1111111111111111111-
-1x0000s133300000001-
-1000010111111110008-
-1000010000000333101-
-1111311100011110104-
-1000000000000010104-
-1019001171111010104-
-1000000000011010101-
-6000111111011010006-
-1000333000011010111-
-4011111101011010001-
-1033300101s51010101-
-1011110101011010101-
-5000010101011010101-
-1111010501000010001-
-1001010101000011104-
-1091010100033300104-
-1000010101111010101-
-1f00s10000000000001-
-1117111111111111111-
---------------------
