        111
        1s1
        1 1
        1 1
        1 1
     1111 1
     1d   1
     1  111
     1  11
     1   1
     111 1
       1 1
       1 1
    1111 1111
    1       1
    1   111 1
    1   1 1 1
    1  d1 1 1
    11111 1 1
   111111 1 1
   1    111 1
   1 11     1
   1 11111111
   1 1
1111 1111111  111111
1          1111d   1
1    11111         1
1    1   1111111   1
1    1     11111   1
111111     1       1
           1  f    1
           111111111