 111
 1s1 111111111
 1 1 1       1
 1 111 11111 1
 1     1   1 1
 1  d  1   1 1
 1111111   1 1
           1 1111
           1    1
           111  1
 11333111    1  1
11      1  111  1
1  1111 1  1    1
1 111 1 1111 1111
1   1 1      1
111 1 11111111
  1 1111
111    1
1d     1
1      1
1  4   1
1      1
111 1111
  1 1
  1 1111111       31111111111
  1 11    333333333         1
  1    d1                   1
  11111   1111111111        1
      1   1        1    f   1
      11111        1111111111
