111  11111111
1s1  1      1
1 1111   7  111111
1       d1       1
1111111   7 111  1
      1     1 1  11
      1111111 1   1
            111   1
            1     1 
            1     1
            1  d7 1 
            1  1  1
            1     1
            111 111
              1 1
              1 1111
            111d   1
            1      1
            1      1
            1  f   1
            11111111